{
    "groundTextureUrl": "./textures/ground.jpg",
    "wallTextureUrl": "./textures/wall.jpg",
    "size": { "width": 10, "height": 10 },
    "map": [
        [3, 2, 2, 3, 2, 2, 2, 3, 2, 2, 1],
        [1, 0, 0, 1, 0, 0, 0, 1, 0, 0, 1],
        [1, 0, 0, 1, 0, 0, 0, 1, 0, 0, 1],
        [1, 0, 0, 1, 0, 0, 0, 1, 0, 0, 1],
        [3, 2, 2, 2, 2, 2, 2, 2, 2, 2, 1],
        [1, 0, 0, 0, 0, 0, 0, 0, 0, 0, 1],
        [1, 0, 0, 0, 0, 0, 0, 0, 0, 0, 1],
        [1, 0, 0, 0, 0, 3, 2, 2, 1, 0, 1],
        [1, 0, 0, 0, 0, 1, 0, 0, 1, 0, 1],
        [1, 0, 0, 0, 0, 1, 0, 0, 1, 0, 1],
        [2, 2, 2, 2, 2, 2, 2, 2, 2, 2, 0]
    ],
    "initialPosition": [0, 0],
    "initialDirection": 0.0
}